{
    "rows": 10,
    "cols": 10,
    "map": [
        1,1,1,1,1,1,1,1,1,1,
        1,0,0,0,0,0,0,0,0,1,
        1,0,1,1,1,0,1,1,0,1,
        1,0,0,0,0,0,0,0,0,1,
        1,0,1,0,1,1,1,0,1,1,
        1,0,0,0,0,0,0,0,0,1,
        1,0,1,0,1,1,1,0,1,1,
        1,0,1,0,1,1,1,0,0,1,
        1,0,0,0,0,0,0,0,1,1,
        1,1,1,1,1,1,1,1,1,1
    ]
}